NO ./assets/no.xpm
SO ./assets/so.xpm
WE ./assets/we.xpm
EA ./assets/ea.xpm

F 220,100,0
C 225,30,0

      11111111111      
   11100000000000111   
  1000000000000000001  
 100000011111110000001
10000001       10000001
100N0001       10000001
10000001       10000001
 100000011111110000001
  1100000000000000011  
    110000000000011   
      11111111111      
