NO ./assets/so.xpm
SO ./assets/so.xpm
WE ./assets/so.xpm
EA ./assets/so.xpm

F 34,34,34
C 170,170,170



        1111111111111111111111111
        1000000000110000000000001
        1011000001110000000000001
        1001000000000000000000001
111111111011000001110000000000001
100000000011000001110111111111111
11110111111111011100N00010001
11110111111111011101010010001
11000000110101011100000010001
10000000000000001100000010001
11111111111111111111111111111




