NO ./assets/wood.xpm
SO ./assets/wood.xpm
WE ./assets/wood.xpm
EA ./assets/wood.xpm
D ./assets/door.xpm

F 0,0,0
C 28,16,9



        1111111111111111111111111
        1000000000110000000000001
        1011000001110000000000001
        1001000000D000000000W0001
111111111011000001110000000000001
100000000011000001110111111111111
11110111111111011100000010001
11110111111111011101010010001
11000000110101011100000010001
10000000000000001100000010001
11111111111111111111111111111




